29,22 28,22 27,22 26,22 25,22 24,22 23,22 22,22 21,22 20,22 19,22 18,22 17,21 16,21 15,21 14,21 13,21 12,22
5,21 5,20 5,19 5,18 5,17 5,16 5,15 4,14 3,13 2,12 1,11 0,10 0,9 0,8 0,7 0,6 1,5 2,4 2,3 3,2
17,29 18,28 19,27 20,26
25,9 24,9 23,10 22,10 21,10 20,10 19,11 18,12 17,13 16,14 15,15 14,16 13,17 12,18 11,19 10,20
29,23 29,22 29,21 29,20 28,19 27,18 26,17 25,16 24,15 23,14 22,13 21,12 20,11 19,10 18,9 17,8
11,29 11,28 11,27 11,26 11,25 11,24 11,23 11,22 11,21 10,20 11,19 12,18 13,17 13,16 13,15 13,14 14,13 15,12
6,1 5,2 4,3 3,4 2,5 1,6 0,7 0,8 0,9 0,10 0,11 0,12 0,13 0,14 1,15 2,16 3,17 4,18 5,19 6,20 7,21 8,22 9,23 10,24 11,25
1,0 2,0 3,0 4,0 5,0 6,0 7,0 8,1 9,2 10,3 11,4 12,5 12,6 12,7 12,8 12,9 12,10 12,11 12,12 11,13 12,14 13,15 14,16 15,17 16,18 17,19 18,20
5,27 6,27 7,27 8,27 9,27 10,26 11,25 12,24 13,23 14,22 15,21 16,20 17,19 18,18 19,17 20,16 21,15
0,10 0,9 0,8 0,7 1,6 2,5 3,4 4,4 5,3 6,3 7,2 8,2 9,1
