26,11 26,12 26,13 26,14 26,15 26,16 26,17 26,18 26,19 26,20 26,21 26,22 27,23 28,24
4,20 4,19 4,18 4,17 4,16 4,15 4,14 4,13 4,12 4,11 4,10 5,9 6,9 7,9 8,9 9,9 10,9 11,9 12,9 13,9 14,9 15,9 16,9 17,9 18,9 19,9
9,5 8,6 7,7 6,8 5,9 4,10 4,11 4,12 4,13 5,14 6,15 6,16 7,17 8,18 9,19 10,19 11,20 12,20 13,21 14,22 15,23 16,24
14,12 15,12 16,12 17,12 18,12 19,12 20,12 21,12 22,12 23,12 24,12 25,12 26,13 27,14 28,15
17,25 16,25 15,25 14,24 13,23 12,22 11,21 10,20 9,19 8,18 8,17 7,16 7,15 7,14 6,13 5,12 4,11 4,10 4,9 5,8 6,7 7,6 8,5 9,4 10,3 11,2 12,1 13,0 14,0 15,0 16,0
4,29 3,29 2,29 1,28 1,27 1,26 1,25 1,24 1,23 1,22 1,21 1,20 0,19 0,18 0,17 0,16 0,15 0,14 0,13 0,12 0,11 0,10 0,9 0,8 0,7 1,6
25,4 25,5 25,6 25,7 25,8 25,9 25,10 25,11 25,12 25,13 25,14 25,15 25,16 25,17 25,18 25,19 25,20 25,21 25,22 25,23 25,24 25,25 25,26 26,27 27,28 28,29
13,29 13,28 13,27 14,26 15,25 16,25 17,25 18,25 19,25 20,25 21,25 22,24 23,23 24,22 24,21 24,20 24,19 24,18 24,17 25,16 26,15 27,14
19,0 18,0 17,0 16,0 15,0 14,0 13,0 12,0 11,0 10,0 9,0 8,0 7,0 6,0 5,0 4,0 3,0 2,0 1,1 0,2
22,9 22,10 22,11 22,12 22,13 22,14 22,15 22,16 22,17 22,18 22,19 23,20 24,21 24,22 23,23 22,24 21,25 20,25 19,25 18,25 17,25 16,25 15,25 14,25 13,25 12,25 11,25 10,25 9,26 8,27 7,28 6,29
