60,109 60,108 61,107 62,106 63,105 63,104 63,103 63,102 63,101 63,100 63,99 64,98 65,97 66,96 67,95 68,94 69,93 70,93 71,93 72,93 73,93 74,93 75,93 76,93 77,93 78,93 79,93 80,93 81,93 82,92 83,91 84,90 85,89 86,88 87,87 88,86 89,85
48,15 47,15 46,15 45,15 44,15 43,15 42,15 41,15 40,16 39,17 38,18 37,19 36,20 35,21 34,22 33,22 32,22 31,22 30,22 29,22 28,22 27,23 26,24 25,25 24,26 23,27 22,28
51,17 51,18 51,19 51,20 51,21 50,22 50,23 49,24 48,25
245,249 244,249 243,249 242,249 241,249 240,249 239,249 238,249 237,249 236,249 235,249 234,248
152,112 151,112 150,111 149,110 148,109 147,108 146,107 145,106 144,105 143,104 142,103 141,102 140,101 139,100 138,99 137,98 136,97 135,96 134,95 133,94 132,93 132,92 132,91 132,90 132,89 132,88 133,87 134,86 135,85 136,84 137,83
66,70 65,70 64,70 63,70 62,69 61,68 60,68 59,67 58,67 57,67 56,67 55,66 54,65
0,86 0,87 0,88 1,89 2,89 3,89 4,89 5,89 6,89 7,89
180,190 181,190 182,191 183,192 183,193 184,194 185,195 186,196 187,197 188,198 189,199 190,200 191,201 192,202 192,203 192,204 192,205 192,206 192,207 192,208 192,209 192,210 192,211 192,212 192,213 191,214 190,215 189,216 188,217 187,218 186,219
124,0 125,0 126,0 127,0 128,0 129,0 130,0 131,1 132,2 133,3 134,4 135,5 136,6 137,7 138,8 139,9 140,10 140,11 140,12 140,13 140,14 140,15 141,16 142,17
18,85 18,84 18,83 18,82 19,81 20,80 21,79 22,78
126,6 126,7 126,8 126,9 126,10 126,11 126,12 127,13 128,14 129,15 130,16 131,17 132,18 133,19 134,20 135,21 136,22 137,23 138,24 139,25 139,26 139,27 140,28
59,177 58,176 57,176 56,176 55,176 54,176 53,176 52,176 51,176 50,175 49,174 48,173 47,172 46,171 45,170 44,169 43,168 42,167 41,166 40,165 39,164 38,163 37,162 36,161 35,160
0,35 1,35 2,35 3,35 4,35 5,35 6,35 7,35 8,35 9,35 10,35 11,35 12,35 13,35 14,35 15,35 16,35 17,35 18,35 19,35 20,34 21,33 22,32 23,32 24,31 25,31 26,30 27,29
150,215 150,216 150,217 149,218 148,219 147,220 147,221 146,222 147,223 148,224 149,225 150,226 151,227 152,228 153,229 154,230 155,231 156,232 156,233 156,234 155,235
216,109 216,110 216,111 216,112 216,113 216,114 216,115 215,116 215,117 215,118
128,13 128,14 129,15 130,16 131,17 132,18 133,19 134,20 134,21 135,22 136,23
102,205 102,204 102,203 102,202 102,201 102,200 101,199 100,198 100,197 99,196 98,195 97,194 96,193 96,192 96,191 96,190 95,189 94,188 93,187
34,18 35,18 36,18 37,18 38,18 39,18 40,18 41,17 42,16 43,16 44,16 45,16 46,16 47,16 48,16 49,16 50,16 51,15 52,15
148,249 148,248 148,247 148,246 148,245 148,244 148,243 148,242 148,241 148,240 148,239 148,238 148,237 148,236 148,235 148,234 148,233 148,232 148,231 148,230 148,229 149,228 150,227 151,226 152,225 153,224
138,80 138,79 138,78 138,77 138,76 138,75 138,74 137,73 138,72 139,71
130,78 131,78 132,78 133,78 134,78 135,78 136,77 137,77 138,77 139,77 140,77 141,77 142,77 143,78 144,79 145,80 146,81 147,81
5,244 5,243 5,242 5,241 5,240 5,239 5,238 5,237 4,236 4,235 4,234 4,233 3,232 4,231 5,230 6,229 7,228 8,227 9,226 10,225
8,244 9,244 10,244 11,244 12,244 13,244 14,244 15,244 16,244 17,244 18,244 19,244 20,244 21,244 22,244 23,244 24,244 25,243 26,242 27,241 28,240 29,239
23,121 22,121 21,120 20,119 19,119 18,119 17,118 16,117 15,116 14,115 13,114 13,113 12,112 11,111 10,110 9,109 8,108 7,107 6,107 5,107 4,106 3,105 2,105 1,104 0,103 0,102 0,101 0,100
67,37 67,38 67,39 67,40 67,41 67,42 67,43 67,44 68,45 69,46 70,47 71,48 71,49 71,50 71,51 71,52 71,53 71,54 71,55 71,56 71,57 71,58 71,59 71,60 71,61 71,62 71,63 72,64
210,12 209,12 208,12 207,12 206,12 205,12 204,13 203,14 202,14 201,14 200,15 199,16
41,47 40,48 40,49 40,50 40,51 40,52 40,53 40,54 39,55 38,56 38,57 38,58 38,59 38,60 38,61 39,62 40,63 41,64 42,65 43,66 44,67 45,68 46,69 47,70 48,70 49,70 50,70 51,70 52,71 53,72 54,73 55,74 56,75 57,75 58,76
203,190 203,189 203,188 203,187 203,186 203,185 203,184 204,183 205,182 206,181 207,180 208,179 209,178 210,177 211,176 212,176 213,176 214,175 215,174 216,173 216,172 216,171 216,170 216,169 216,168 215,167 214,166 213,165 212,164
114,84 114,83 113,82 113,81 113,80 112,79 111,78 110,77 109,76 108,75 107,74 106,73 105,72 104,71 103,70 102,69 101,68 100,67 99,66 98,65 97,64 96,63 95,62 95,61 94,60
204,116 204,117 205,118 206,119 207,120 207,121 207,122 207,123 207,124 207,125 207,126 206,127 205,128 204,129 203,130 202,131
123,240 123,239 123,238 123,237 123,236 123,235 123,234 124,233 125,232 126,231 127,230 128,229 129,228 130,227 131,226 132,225 133,224 134,223 135,222 136,221 136,220 135,219 134,218 133,218 132,218 131,218 130,218 129,218 128,217 127,216 126,215
178,167 178,166 178,165 178,164 178,163 178,162 177,161 176,160 175,159 174,158 173,157 172,156 171,155 170,154 170,153 169,152 169,151 168,150 167,149 166,148 165,147 164,146 164,145 163,144 162,143 161,142 160,141 159,140 158,139 157,139 156,139 155,139 154,138 153,137
191,111 191,110 191,109 191,108 191,107 191,106 192,105 193,104 194,103 195,102 196,101 197,100 198,99 199,98 200,97 201,96 202,95 203,94 204,93 205,92 206,91 207,90 208,89 209,89 210,89 211,89 212,88
246,139 246,140 246,141 246,142 246,143 246,144 246,145 246,146 246,147 246,148 246,149 245,150 244,151 243,151 242,151 241,151 240,151 239,151 238,150 237,150 236,149 235,148 234,147 233,147 232,147 231,147 230,147 229,147 228,147 227,147 226,148 225,149 224,150 223,151 222,152 221,153 220,154 219,155 218,156 217,156
124,41 125,41 126,41 127,41 128,41 129,41 130,41 131,41 132,41 133,42 134,43 135,44 136,45 137,46 138,47 139,47 140,48 141,49 142,50 143,51 144,52
76,99 76,98 76,97 75,96 74,95 74,94 73,93 72,93 71,93 70,93 69,93 68,93 67,93 66,92 65,91 64,90 63,89
143,228 143,227 142,226 141,225 140,224 139,223 138,222 137,221 136,220 135,219 134,218 133,218 132,218 131,218 130,218 129,217 128,216 127,215 126,214 125,213 124,212 123,212 122,211 121,211 120,210 119,210 118,210
154,141 153,141 152,141 151,141 150,141 149,141 148,141 147,140 146,139 145,138 144,137 143,136 142,135 141,134 140,133 139,132 138,131 137,130 136,129 135,128 134,127 133,126 132,125 131,124 130,123 130,122 130,121 129,120 128,119 127,118
62,78 62,77 62,76 62,75 62,74 62,73 62,72 63,71 63,70 63,69 63,68 63,67 63,66 63,65 63,64 63,63 63,62 63,61 63,60 62,59 62,58 61,57 60,56 59,55 58,54 57,53 56,52 56,51 55,50 54,49
155,70 156,70 157,70 158,70 159,71 160,71 161,71 162,71 163,71 164,71 165,71 166,71 167,70 168,70 169,70 170,70 171,70 172,70 173,70 174,69 175,69 176,69 177,70 178,70 179,70 180,70 181,70 182,69
200,188 199,188 198,188 197,188 196,188 195,189 194,190 193,191
246,0 247,0 248,0 249,1 249,2 249,3 249,4 249,5 249,6 249,7 249,8 249,9 249,10 249,11 249,12 249,13 249,14 249,15 249,16 249,17 249,18 249,19 249,20 249,21 249,22 249,23 249,24 249,25 248,26
50,23 51,24 52,25 53,26 54,27 55,28 56,29 57,30 58,31 59,32 60,33 61,34 62,35 63,36 64,35 65,36 66,37 67,38 68,39 69,39 70,40 71,41 72,41 73,41 74,41 75,42 76,42
114,206 113,205 113,204 113,203 113,202 113,201 113,200 113,199 113,198 113,197 113,196 113,195 114,194 115,193 116,192 117,191 118,190 119,189 120,188 121,187 121,186 122,185 123,184 124,183 125,182
173,210 174,210 175,210 176,211 177,212 178,213 179,213 180,213 181,213 182,213 183,213 184,213 185,213 186,213 187,212 188,212 189,212 190,212 191,212 192,213 193,214
205,29 204,29 203,29 202,29 201,29 200,28 199,27 198,26 197,25 196,25 195,24 194,23 193,22 192,21
151,69 150,69 149,69 148,69 147,69 146,69 145,69 144,68 143,68 142,67 141,66 140,65 139,64 138,63 137,62 136,61 135,60 134,59 133,58 132,57 131,56 130,55 129,54 128,53 127,52 126,51 126,50 125,49 125,48 125,47 124,46 123,45 122,44 121,43
167,201 166,201 165,200 164,199 163,199 162,198 161,197 160,196 159,195 158,194 157,193 156,192 155,191 154,190 153,189 152,188 151,187 150,187 149,187 148,187 147,187 146,187 145,187 144,187 143,186
182,145 181,145 180,144 179,143 178,142 177,141 176,140 176,139 176,138 176,137 176,136 176,135 175,134 174,133 173,132 172,131 171,131 170,131 169,131 168,131 167,130 166,129 165,128 164,127 163,126 162,125 161,124 160,123 159,122 159,121 159,120 160,119 161,118 162,117 163,116 164,115
135,130 134,130 133,130 132,129 131,129 130,129 129,129 128,129 127,130 126,130 125,131 124,132 123,133 122,134 121,135 120,136 119,137 118,137 117,137 116,137 115,137 114,137 113,137 112,137 111,137 110,137 109,137 108,137 107,138
148,218 148,217 148,216 148,215 147,214 146,213 145,212 145,211 144,210 143,209 142,208 141,207 140,206 140,205 139,204 138,203 137,202 136,201 136,200 136,199 136,198 136,197 136,196 136,195 136,194 135,193 134,192 133,191 132,190 131,190 130,190 129,190 128,190 127,189
57,35 57,34 58,33 59,32 60,31 61,30 62,29 63,29 64,29 65,29 66,29 67,28 68,27 69,26 70,25 71,24 72,23 73,22 74,21 75,20 76,19 77,18 78,18 79,18 80,18 81,17 82,16 83,15 84,14 85,13 86,12
67,201 68,201 69,201 70,201 71,201 72,201 73,201 74,201 75,201 76,201 77,201 78,201 79,201 80,201 81,201 82,201 83,201 84,201 85,201 86,201 87,201 88,201 89,201 90,201 91,201 92,200 93,199 94,198 95,197 96,196
172,110 171,109 170,108 169,107 168,106 167,105 166,104 165,103 164,102 163,101 163,100 162,99 161,98 160,97 159,96 158,95 157,94 156,93 155,92 154,91 153,90 152,89 151,88
6,229 7,229 8,229 9,229 10,229 11,229 12,229 13,229 14,229 15,229 16,229 17,228 18,228 19,228 20,228 21,228 22,228 23,228 24,228 25,228 26,228 27,228 28,229 29,230 30,231 31,232 32,233
169,159 170,159 171,159 172,159 173,159 174,159 175,159 176,160 177,161 178,162 179,163 180,164 181,165 182,166 183,167 184,168 185,169 186,170 187,171 188,172 189,173 190,174 191,175 192,176 193,177 194,178 195,179
182,191 183,192 183,193 184,194 185,195 186,196 187,197 188,198 189,199 190,200 191,201 192,202 192,203 192,204 191,205 190,206 189,207 188,208 187,209 186,209 185,209 184,209 183,209 182,209 181,209 180,209 179,208 178,207 177,207 176,206 175,207 174,208 173,209 172,210 171,211 170,211 169,212 168,213 167,213 166,213 165,213 164,213 163,213 162,213 161,213 160,213 159,214 158,215 157,216
219,108 220,108 221,107 222,106 223,106 224,105 225,104 226,103 227,102 228,101 229,101 230,101 231,101 232,100
78,39 77,39 76,38 75,37 74,36 73,35 72,34 72,33 71,32 70,31 69,30 68,29 67,28 66,27 65,26 64,25 63,24 62,23 62,22 61,21 60,20 59,19 58,18 57,17 56,16 55,15 54,14 53,13
19,20 20,20 21,20 22,20 23,21 24,22 25,23 26,24 27,25 28,26 29,26 30,27 31,28 32,29 33,30 34,31 35,32 35,33 36,34 37,35 38,36 38,37 39,38 40,39 41,40 41,41 42,42 43,43 44,43 45,43 46,43 47,43 48,42 48,41 48,40 48,39 48,38 48,37 49,36
26,89 27,89 28,89 29,89 30,89 31,89 32,89 33,89 34,89 35,89 36,89 37,90 38,91 39,91 40,91 41,91 42,91 43,90 44,89 45,88 46,87 47,86
2,172 2,171 2,170 2,169 2,168 2,167 2,166 2,165 2,164 2,163 2,162 2,161 2,160 2,159 2,158 2,157 2,156 2,155 2,154 2,153 2,152 1,151 1,150 0,149 0,148 0,147 0,146 0,145 0,144 0,143 1,142
62,14 61,14 60,15 60,16 60,17 60,18 60,19 60,20 60,21 60,22 60,23 60,24
27,134 26,134 25,134 24,134 23,134 22,134 21,134 20,133 19,132 18,131 17,130 16,130 15,129 15,128 15,127 15,126 15,125 15,124 15,123 15,122 14,121 13,120 12,119
1,123 1,122 1,121 1,120 1,119 1,118 1,117 1,116 0,115 0,114 0,113 0,112 0,111 0,110
243,10 242,10 241,10 240,11 239,12 239,13 239,14 239,15 239,16 239,17 239,18 238,19 237,20 236,21 235,22 234,23 233,24 232,25 231,26 230,27 229,28 228,29 227,30 226,31 225,32 224,32 223,33 222,34 221,35 220,36 219,37 218,38
201,105 200,105 199,105 198,104 197,103 196,102 195,101 194,100 193,99 192,98 191,97 190,96 189,95 188,94 187,93 186,92
103,218 102,218 101,218 100,218 99,218 98,219 97,220 96,220 95,220 94,220 93,221 92,222 91,223 90,224 89,225 88,226 87,227 86,228 85,229 84,230 83,231 82,232 82,233 83,234 84,234 85,234
109,70 109,69 108,68 107,67 106,66 105,65 104,64 104,63 104,62 104,61 104,60 104,59 104,58 105,57 106,56 106,55 107,54
114,59 114,58 115,57 116,56 117,55 118,54 119,53 120,52 121,51 122,50 123,49 123,48 124,47 125,46 126,45 127,44 128,43 129,43 130,42
221,177 220,177 219,177 218,177 217,177 216,177 215,177 214,177 213,176 212,176 211,176 210,176 209,176 208,176 207,177 206,178 205,179 204,180 203,181 202,181 201,182 200,183 199,184 198,185 197,186 196,187 195,188 194,188 193,188 192,189 191,190
54,4 55,4 56,4 57,4 58,4 59,5 60,6 60,7 60,8 60,9 59,10 59,11 59,12 59,13 59,14 59,15 59,16 58,17 57,18 56,19 55,20 54,21
159,40 160,40 161,40 162,40 163,40 164,40 165,40 166,40 167,40 168,40 169,40 170,40 171,40 172,40 173,41 174,42 175,43 176,44 177,45 178,46 179,47 180,48 181,49 182,50 183,51 184,52 184,53 184,54 184,55 185,56 186,57 187,58
176,223 177,224 178,224 179,224 180,224 181,223 182,222 183,221 184,220 185,219 186,218 187,217 188,216 189,215
137,3 137,4 138,5 139,6 140,7 141,8 142,9 143,10 144,11 145,12 146,13 147,14 148,15 149,16 150,17 151,17 152,17 153,18 154,18 155,18 156,18 157,19
236,224 236,225 236,226 236,227 235,228 235,229 235,230 236,231 237,232 238,233 239,234 240,235 241,236 242,237 243,238 244,239 245,240 246,241 247,242 248,243 248,244 249,245 249,246
200,14 200,15 200,16 200,17 200,18 200,19 200,20 200,21 200,22 200,23 200,24 200,25 199,26 199,27 199,28 200,29 200,30 201,31 202,32 203,33 203,34 203,35 204,36 205,37
115,164 116,163 117,163 118,163 119,163 120,163 121,163 122,163 123,164 124,165 125,166 126,167 127,168 128,168 129,169 130,169 131,170 132,170 133,170 134,170 135,170 136,170 137,170 138,170 139,170 140,170 141,171 142,172
194,240 193,240 192,241 191,242 190,243 189,244 188,245 187,246 186,247 185,247 184,246 183,245 183,244 183,243 182,242 181,241 181,240 180,239 179,238 179,237 179,236 178,235
72,25 72,24 72,23 72,22 72,21 72,20 72,19 72,18 72,17 72,16 72,15 71,14 70,13 69,12 68,11 67,10 66,9 65,8 64,7 63,6 62,5 61,4 60,3 59,2 58,1
23,121 23,120 23,119 23,118 23,117 23,116 23,115 23,114 23,113 22,112 21,111 20,110 20,109 19,108 18,107
145,240 145,239 145,238 146,237 147,236 148,235 148,234 148,233 148,232 147,231 146,230
202,76 201,76 200,77 200,78 199,79 198,80 197,81 196,82 195,83 194,84 193,85 192,86 191,87 190,88 189,88 188,89 187,90 186,91
138,51 139,51 140,50 141,49 142,50 142,51 143,52 144,53 145,54 146,55 147,56 148,57 149,58 150,59 151,60 152,60 153,60 154,60 155,60
166,141 167,141 168,142 169,143 170,144 171,145 172,146 173,147 174,148 175,149 176,150 177,151 178,152 179,153 180,154 181,155 182,156 183,157 184,158 185,159 186,160 187,161 188,162 189,163 190,164 191,165 192,166 193,167 194,168 195,169
245,122 245,121 245,120 244,119 243,118 242,117 241,116 240,116 239,116 238,116 237,116 236,116 235,116 234,115 233,114 232,113 231,112 230,111 229,110 228,109 227,108 226,107 225,106 224,105
33,227 33,226 33,225 34,224 35,224 36,224 37,224 38,224 39,224 40,224 41,224 42,224 43,224 44,224 45,224 46,224 47,224 48,224 49,224 50,224 51,224 52,224 53,224 54,224 55,224 56,224 57,224 58,224
134,108 133,108 132,108 131,108 130,108 129,108 128,107 127,107 126,107 125,107 124,107 123,107 122,106 121,105 120,104 119,103 118,102 118,101 117,100 116,99 115,98 115,97 115,96 115,95 115,94 115,93 115,92 115,91 115,90 115,89 115,88 114,87 114,86 114,85 114,84 113,83 112,82 111,81 110,80 109,79 108,78
178,6 177,6 176,6 175,6 174,6 173,6 172,6 171,6 170,5 169,5 168,4 167,4 166,5 165,6
101,10 100,10 99,10 98,10 97,11 96,12 95,13 94,14
212,243 213,244 214,245 215,246 216,247 217,248 218,249 219,249 220,249 221,249 222,249 223,249 224,249 225,249 226,249 227,249 228,249 229,249 230,249 231,249 232,249 233,249 234,248
66,223 67,223 68,223 69,223 70,222 71,222 72,222 73,222 74,222 75,222 76,222 77,222 78,222 79,221 80,221 81,221 82,222 83,222 84,222 85,222 86,221 87,220
173,205 174,205 175,205 176,205 177,205 178,205 179,205 180,205 181,204 182,205 183,206 184,207 185,208 186,209 187,209 188,208 189,207 190,206 191,205 192,204 192,203 192,202 191,201 190,200 189,200 188,199 187,198 186,197 185,196 184,195 183,194 182,193 181,192 180,191 179,190 178,189 177,188 176,187
241,157 240,157 239,157 238,157 237,157 236,156 235,155 234,154 233,153 232,152 232,151 231,150 231,149 230,148 229,147 228,146 227,145 226,144 225,143 224,142 223,141 222,140 221,139 220,138 219,137 218,136 217,136 216,135 215,134 214,133 213,132 212,131
49,48 50,49 51,49 52,49 53,49 54,49 55,49 56,49 57,49 58,49 59,49 60,49 61,49 62,50 63,51 64,52 65,53 66,54 67,55 68,56 69,57 70,58 71,59 72,60 73,60 74,61 75,62 76,63 77,64
100,131 99,131 98,131 97,131 96,131 95,131 94,131 93,131 92,131 91,131 90,131 89,131 88,131 87,132 86,131 85,130 85,129 85,128 85,127 85,126 85,125 85,124 85,123 85,122 84,121 83,120 82,119 81,118 80,117 79,116 78,115 77,114
138,152 138,151 138,150 138,149 138,148 138,147 138,146 137,145 136,144 135,143 134,143 133,143 132,143 131,143 130,143 129,143 128,143 127,143 126,143 125,143 124,143 123,142 122,142 121,142 120,142 119,142 118,142 117,142 116,142 115,142 114,141
30,44 29,44 28,44 27,44 26,44 25,44 24,44 23,44 22,44 21,44 20,44 19,44 18,43 17,43 16,42
45,110 45,109 45,108 45,107 45,106 45,105 45,104 46,103 46,102 46,101 46,100 47,99 48,98
166,178 167,178 168,178 169,178 170,178 171,178 172,177 173,176 174,175 175,174 176,173 177,172 177,171 177,170 177,169 177,168 177,167 177,166 177,165 177,164 177,163 177,162 177,161 176,160 176,159 176,158 176,157 176,156 175,155 176,154 177,153
