69,56 69,55 69,54 69,53 68,52 68,51 68,50 68,49 68,48 68,47 68,46 68,45 68,44 68,43 68,42 68,41 68,40 68,39
171,7 171,8 171,9 171,10 171,11 171,12 171,13 172,14 172,15 172,16 172,17 172,18 172,19 172,20 172,21 171,22 171,23 171,24 171,25 171,26 170,27 169,28 168,29 167,29 166,30 165,30 164,29
223,129 222,129 221,129 220,129 219,129 218,129 217,129 216,129 215,129 214,129 213,129 212,130 211,131 210,132 209,133 208,134 207,135 206,136 205,137 204,138 203,139 202,140 201,141 200,142 199,143 198,144 197,145
213,241 214,241 215,241 216,241 217,241 218,240 219,239 220,238 221,238 222,239 222,240 221,241 220,242 220,243 219,244
199,129 200,128 201,127 202,126 203,126 204,126 205,126 206,125 207,125 208,125 209,125 210,125 211,125 212,125 213,125 214,126 215,127 216,128 217,129 218,130 219,131 220,132 221,133 222,134 223,135 224,135 225,135 226,135 227,136
164,103 164,102 164,101 164,100 164,99 164,98 164,97 164,96 164,95 164,94 164,93 164,92 164,91 163,90 162,89 162,88 161,87 161,86 161,85 161,84 161,83 161,82 161,81 161,80 162,79
125,24 125,25 125,26 125,27 125,28 125,29 125,30 125,31 125,32 126,33 127,34 128,34 129,33 130,33 131,33 132,33
63,125 63,126 63,127 62,128
26,213 25,213 24,213 23,212 22,212 21,212 20,212 19,212 18,213 18,214 18,215 18,216 19,217 20,218 21,219 22,220 23,221 24,222 25,223 26,224
121,0 121,1 121,2 121,3 121,4 121,5 122,6 123,7 124,8 125,9 126,10 127,11 127,12 128,13 129,14 130,15 131,16 132,17 133,17 134,17 135,17 136,17 137,17 138,18 139,19 140,20 141,21 142,22 143,23
66,107 65,107 64,108 64,109 63,110 62,111 61,112 60,113 59,114 58,114 57,114 56,115 55,116 54,117 53,118 52,119 52,120 52,121 52,122 51,123 50,124 49,125 48,126 47,127 46,128
25,15 25,16 25,17 25,18 25,19 25,20 25,21 25,22 25,23 25,24 25,25 25,26 25,27 24,28 23,29 22,30 21,31
2,209 1,209 0,208 0,207 0,206 0,205 0,204 0,203 0,202 0,201 0,200 0,199 0,198 0,197 0,196 0,195 0,194 0,193 0,192 0,191 0,190 0,189 0,188 0,187 0,186 1,185
245,139 245,138 245,137 245,136 245,135 245,134 245,133 245,132 245,131 245,130 245,129 245,128 245,127 245,126 245,125 244,124 243,123 242,122 241,121 240,120 239,119 238,118 237,117 236,116
122,164 122,163 122,162 122,161 122,160 122,159 122,158 122,157 122,156 122,155 122,154 122,153 122,152 122,151 122,150 122,149 122,148 122,147 122,146 122,145 122,144 122,143 121,142 120,141
169,54 168,54 167,54 166,55 165,56 164,57 163,58 162,59 161,60 160,60 159,60 158,60 157,61 156,62
199,147 198,147 197,147 196,147 195,147 194,147 193,147 192,147 191,147 190,146 189,145 188,144 187,143 186,142 185,141 184,140 183,139 182,138 181,137 181,136 181,135 181,134 181,133 181,132 181,131 181,130 181,129 181,128 182,127 183,126
176,60 177,61 178,62 179,63 180,64 181,65 182,66 183,66 184,67 185,67 186,67 187,67 188,68
58,167 59,167 60,166 61,167 62,168
85,41 85,42 85,43 85,44 86,45 86,46 86,47 86,48 86,49 86,50 85,51 85,52 85,53
9,103 9,102 8,101 8,100 8,99 8,98 8,97 8,96 8,95 8,94 8,93 8,92 8,91 9,90 10,89 11,88 12,87 13,86 14,85 15,84 16,83 17,82 18,81 19,80 20,79 21,78 22,77 22,76 22,75 23,74
83,26 84,26 85,26 86,25 87,25 88,25 89,25 90,24 91,23 92,22 93,22 94,21 95,21 96,21 97,21 98,21 99,21
224,202 225,202 226,202 227,203 228,203 229,203 230,203 231,204 232,205 233,206 234,207 234,208 234,209 234,210 234,211 234,212 234,213 233,214 233,215 233,216 234,217 235,218 235,219 236,220 237,221 238,222 239,223 240,224 241,225 242,226 243,227
25,38 25,37 25,36 25,35 25,34 26,33 27,32 27,31 27,30 27,29 27,28 27,27 27,26 27,25 27,24 26,23 26,22 26,21 26,20 27,19 28,18 29,17 30,16
153,7 152,7 151,7 150,7 149,7 148,7 147,7 146,7 145,8 144,9 143,10 142,11 141,12 140,13 139,14 138,14 137,14 136,15 135,16
32,249 31,249 30,249 29,249 28,249 27,249 26,249 25,249 24,249 23,249 22,249 21,249 20,249 19,249 18,249 17,249 16,249 15,249 14,249 13,249 12,249 11,249 10,249 9,249 8,249 7,249 6,249 5,248 4,247 3,246
22,83 23,83 24,84 25,85 26,86 27,87 28,88 29,89 29,90 30,91 30,92 31,93 32,94 33,95 34,96 34,97 34,98 35,99 36,100 37,101 38,102 39,103 40,104 41,105 42,106 43,107 44,108 45,109 46,110 46,111
198,163 198,164 198,165 198,166 198,167 199,168 200,169 200,170 200,171 200,172 200,173 200,174 200,175 200,176 201,177 201,178 201,179 201,180 202,181 203,182 204,183 205,184
74,65 73,65 72,65 71,65 70,65 69,65 68,65 67,65 66,65 65,65 64,65 63,65 62,66 61,67 60,68 59,68 58,69 57,69 56,69 55,69 54,69 53,70 52,71 51,72 50,73 49,74 48,75 47,76 47,77 47,78 47,79 47,80 47,81 47,82 47,83 47,84 47,85 47,86 47,87 47,88 47,89 46,90 46,91 46,92 46,93 47,94
108,156 109,155 110,155 111,155 112,155 113,155 114,155 115,155 116,156 117,157 118,158 119,159
103,34 103,33 103,32 103,31 103,30 103,29 103,28 102,27 102,26 102,25 103,24 104,23 104,22 104,21 103,20 102,20 101,20 100,20 99,20 98,19
196,104 197,104 198,103 199,102 200,101 201,100 202,99 203,98 203,97 203,96 204,95 204,94 204,93 204,92 204,91
23,110 24,110 25,111 26,112 27,113 28,113 29,114 30,115 31,116 32,117 33,118 34,119
10,61 11,61 12,61 13,61 14,61 15,60 16,60 17,59 18,58 19,57 20,56 20,55 20,54 20,53 20,52 20,51 19,50
100,185 100,184 100,183 99,182 98,181 97,180 96,179 95,178 94,177 93,176 92,175 91,174 91,173 92,172 93,171 94,170 95,169 96,168 97,168 98,168 99,168 100,168 101,169 102,170 103,171 104,172 105,173
228,153 229,153 230,153 231,153 232,153 233,153 234,153 235,153 236,154 237,155 238,156 239,157 240,157 241,158 242,159 243,160 244,161 245,162 245,163
51,179 51,180 51,181 50,182 49,183 48,184 47,185 46,186 45,187 44,187 43,187 42,187 41,187 40,187 39,187 38,187 37,187 36,187 35,187 34,187 33,187 32,188 31,189 30,190
197,101 197,102 197,103 197,104 197,105 196,106 196,107 196,108 196,109 196,110 196,111 196,112 196,113 196,114 197,115 198,116 199,117 200,118 201,118 202,118 203,118 204,118 205,117 206,116 206,115 206,114 207,113 208,112 209,111 210,110
8,88 9,88 10,88 11,88 12,88 13,87 14,87 15,86 16,85
182,242 183,242 184,242 185,242 186,242 187,243 188,243 189,242 189,241 190,240 190,239 190,238 190,237 190,236 190,235 190,234 190,233 189,232 189,231 190,230 191,229 192,228 193,227 194,226 195,225 196,224 197,223 198,222 199,221 200,220 201,219 202,218 202,217 203,216 204,215 205,214 206,213 206,212
16,215 16,216 17,217 18,218 19,219 19,220 20,221 20,222 20,223 20,224 20,225 20,226 20,227 20,228 20,229 20,230 20,231 20,232 21,233 22,234 23,235 24,236 25,237
239,143 239,142 239,141 239,140 239,139 239,138 239,137 239,136 239,135 239,134 239,133 238,132 237,131 237,130 237,129 236,128 235,127 234,126 233,125 232,124 231,123 230,122
31,185 30,185 29,185 28,185 27,185 26,185 25,185 24,185 23,185 22,185 21,184 20,183 19,182 18,181 17,181 16,180 15,180 14,179 13,178 12,177
71,192 72,191 72,190 73,189 72,188 71,187 70,186 69,186 68,185 67,185 66,185 65,185 64,186 63,187 63,188 63,189 63,190 63,191 63,192 63,193
246,41 245,41 244,41 243,41 242,41 241,41 240,41 239,41 238,41 237,41 236,41 235,41 234,41 233,41 232,41 231,41 230,42 229,43 228,44 227,45 226,46 225,47 224,48 223,49 222,49 221,50 220,50 219,51 218,52
51,167 51,168 51,169 51,170 51,171 51,172 51,173 52,174 53,175 54,176 55,177 56,178 57,179 58,180 59,180 60,180 61,180 62,180 63,180 64,181 65,182 66,183 67,184 68,185
222,88 222,89 222,90 222,91 222,92 222,93 222,94 223,95 224,96 225,97 226,98 227,99 226,100 225,101 224,102 223,103 222,104 221,105 220,106 219,107 219,108 219,109 219,110 219,111 219,112
87,110 88,110 89,110 90,111 91,112 91,113 92,114 93,115 93,116 94,117 95,118 96,119 97,120 98,121 99,122 100,123 101,124 102,125 103,125 104,126 105,126 106,126 107,126
65,183 64,183 63,183 62,182 61,182 60,181 59,181 58,181 57,181 56,181 55,181 54,181 53,181 52,181 51,181 50,182 49,183 48,184 47,185 46,186 45,187 44,187 43,188 42,189 41,190 40,191 39,192 38,193 37,194 36,195 36,196 36,197 36,198 36,199 36,200 36,201 36,202 36,203 37,204 38,205 38,206 38,207 38,208 38,209 39,210 40,211
183,96 182,95 182,94 182,93 182,92 182,91 183,90 183,89 183,88 183,87 183,86 183,85 183,84 183,83 184,82 185,81 185,80 185,79 185,78 185,77 185,76 185,75 185,74 185,73 185,72 185,71 184,70 183,69
236,20 236,21 236,22 235,23 234,24 233,25 232,26 231,27 230,28 229,29 228,30 227,31 226,32 225,33 224,33 223,33 222,33 221,33 220,33 219,33 218,33 217,34
64,50 65,50 66,50 67,50 68,50 69,49 70,48 71,48 72,47 73,46
54,76 55,76 56,76 57,75 58,75 59,74
0,152 0,153 1,154 2,154 3,154 4,154 5,154 6,154 7,154 8,155 9,155 10,155 11,156 12,157 13,158 14,159 15,160 16,161 17,161 18,162 19,162 20,163
141,74 142,74 143,74 144,75 145,76 146,76 147,76 148,77 149,78 150,79 151,80 152,81 153,82 154,83 155,84 156,85 157,86 158,87 159,88 160,89 161,90 162,91 163,92 164,93 165,94 166,95 167,96 168,97 169,98 170,99
67,157 68,157 69,157 70,157 71,157 72,157 73,157 74,157 75,157 76,157 77,157 78,157 79,157 80,157 81,157 82,157 83,157 84,157 85,158 86,159 87,160
69,184 70,184 71,184 72,184 73,183 74,183 75,183 76,183 77,183 78,183 79,182 80,182 81,182 82,182 83,182 84,182 85,182 86,183 87,184 88,185 89,185 90,185 91,185 92,185 93,185 94,186 95,187 96,188 97,189 98,189 99,188
71,3 70,3 69,3 68,3 67,3 66,3 65,4 64,5 63,6 62,7 61,8 60,9 59,10 58,11 57,12 56,13 55,14 54,15 54,16 53,17
103,157 103,156 103,155 103,154 103,153 103,152 103,151 103,150 103,149 103,148 103,147 103,146 102,145 101,144 100,143 100,142
83,4 84,4 85,3 86,4 87,5 88,6 89,7 90,8 91,9 92,10 93,11 94,12 95,13 96,13 97,13 98,14 99,15 100,16 101,17 102,18 103,19 104,20 105,21 106,21 107,21 108,22 109,23 110,24 111,25 112,26
128,125 128,124 128,123 128,122 128,121 128,120 128,119 128,118 128,117 127,116
119,240 120,240 121,239 122,238 123,238
22,148 22,147 22,146 23,145 24,144 25,143 26,142 27,141 27,140 28,139 29,138 29,137 29,136 29,135 29,134 29,133 29,132 28,131 29,130 29,129 30,128 31,127 32,126 33,125 34,124 35,123 36,123 37,123 38,123 39,123 40,122
87,55 86,54 85,53 85,52 85,51 86,50 87,50 88,50 89,50 90,50 91,50 92,50 93,50 94,50 95,50 96,50 97,50 98,50 99,49 100,49 101,50 102,51 103,52 103,53 103,54 103,55 103,56 103,57 103,58 103,59 103,60 103,61 103,62 103,63 103,64 103,65 103,66 103,67 103,68 103,69 103,70 103,71 103,72 103,73 103,74 103,75 103,76 103,77 103,78 102,79 101,80 100,81 99,82 99,83 99,84 99,85
18,234 19,234 20,235 21,235 22,236 23,237 24,238 25,239 26,240 27,241 28,242 29,243 30,244 31,245 32,246 33,247 34,248 35,249 36,249 37,249 38,249 39,249 40,249 41,249
157,169 156,169 155,169 154,169 153,169 152,169 151,169 150,168 149,168 148,168 147,168 146,169 145,170 144,171 143,172 142,173 141,174 140,175 139,176 138,177 137,178 137,179 136,180 135,181 134,182
87,166 88,166 89,166 90,166 91,166 92,166 93,166 94,166 95,166 96,166 97,167 98,168 99,169 100,170 101,171 102,172 103,173 103,174 103,175 103,176 103,177 104,178
126,67 125,67 124,67 123,67 122,67 121,67 120,67 119,67 118,67 117,66 116,65 115,65 114,65 113,65 112,64 111,63 110,62 109,61 108,60 107,59 107,58 107,57 107,56 107,55 107,54 107,53 106,52 105,51 105,50
26,77 25,77 24,76 23,76 22,76 21,75 20,75 19,74 18,74 17,74 16,74 15,73 14,73 13,73 12,74 11,75 10,76 9,77
86,57 85,57 84,57 83,57 82,57 81,57 80,57 79,58 78,59 77,60 76,61 75,62 74,63 74,64 74,65 74,66 74,67 74,68 74,69 74,70 75,71 76,72 77,73 78,74
21,179 21,178 21,177 22,176 23,175 24,174 25,173 26,172 27,171 28,170 29,169 30,168 31,167 32,166 33,165 34,164 35,163 36,162 37,161 38,160 39,159 40,158 41,157 42,157 43,157 44,157 45,156
96,106 95,106 94,105 93,106 92,107 91,108 90,109 89,110 88,111 87,112 86,113 86,114 86,115 86,116 85,117 84,118 83,119 82,120 81,121
144,78 145,78 146,78 147,79 148,80 149,81 150,82 151,83 152,84 153,84 154,85 154,86 154,87 153,88 153,89 153,90 154,91 155,92 156,93 157,94 158,95 159,96 160,97 161,98 162,99 163,100 164,101 165,102 166,103 167,104 168,105
179,117 180,117 181,117 182,117 183,117 184,118
87,25 86,25 85,25 84,25 83,25 82,24 81,23 80,22 79,21 78,20 77,19 76,18 75,17 74,16 73,15 72,14 71,13 70,12 69,11 68,10 67,9 66,8 65,7 64,7 63,6 62,5 61,4 60,3 59,2
167,64 167,63 167,62 167,61 167,60 167,59 167,58 167,57 167,56 166,55 165,54 164,53 163,52 162,51 161,50 160,49 159,48 158,47 157,46 156,45 155,44 154,43 153,42 152,41 151,40 150,39 149,39 148,39 147,39 146,38 145,37
39,238 40,238 41,238 42,238 43,238 44,238 45,239 46,239 47,238 48,237 49,236 49,235 49,234 49,233 49,232 48,231 47,230 46,229 45,228 44,227 44,226 44,225 43,224 43,223 42,222 41,221 41,220 41,219 41,218 41,217
173,15 173,16 173,17 173,18 173,19 173,20 173,21 173,22 173,23 173,24 173,25 173,26 173,27 173,28 172,29 172,30 172,31 172,32
66,49 66,50 66,51 65,52 65,53 65,54 64,55 63,56 62,57 61,58 60,59 60,60 59,61 58,62 57,63 56,64 55,65 54,66 53,67 52,68 51,69 50,69 49,70 48,70 47,70 46,70 45,70 44,70 43,71 42,72 41,73 40,74 39,75
36,10 37,10 38,10 39,10 40,10 41,10 42,10 43,10 44,10 45,10 46,10 47,10 48,10 49,10 50,10 51,10 52,10 53,11 54,12 55,13 56,14 57,15 58,16 58,17 58,18 58,19 58,20 59,21 60,22 61,23 62,24 63,25
55,73 56,73 57,73 58,73 59,73 60,73 61,74 62,75 63,76 64,76 65,77 66,78 67,79 68,80 69,81 70,82 71,83 72,84 73,85 74,86 75,87 76,88 77,89 78,90
126,42 126,43 126,44 126,45 126,46 126,47 126,48 126,49 126,50 126,51 126,52 126,53 126,54 126,55 126,56 126,57 126,58 126,59 126,60 125,61 125,62 125,63 125,64 125,65 125,66 125,67 125,68 126,69 127,70
247,102 246,101 245,101 244,100 243,99 242,98 241,98 240,98 239,98 238,98 237,98 236,98 235,98 234,98 233,98 232,98 231,98 230,98 229,97 228,96 227,95 226,94
98,150 98,149 98,148 98,147 98,146 98,145 98,144 98,143 98,142 99,141 99,140 99,139 99,138 99,137 99,136 98,135 98,134 98,133 98,132 98,131 98,130 99,129 99,128 99,127 99,126 99,125 100,124
125,74 124,74 123,74 122,75 121,75 120,75 119,75 118,76 117,77 116,78 115,79 114,79 113,79 112,79 111,79 110,79 109,79 108,79 107,78 106,78 105,77 104,77 103,77 102,77 101,77 100,77 99,77 98,77 97,78 96,79
8,178 9,178 10,179 11,180 12,181 13,182 13,183 13,184 14,185 15,186 16,187 17,188 18,189 19,190 20,191 21,192 22,193 22,194 22,195 23,196 23,197 23,198 23,199
52,115 51,114 50,113 49,112 48,111 47,111 46,110 45,109 44,109 43,108 42,107 41,106 40,105 39,104 38,103 37,102
216,201 216,202 216,203 215,204 214,205 213,205 212,205 211,205 210,205 209,205 208,205 207,205 206,205 205,205 204,205 203,205 202,205 201,205 200,205 199,206 198,206 197,207
78,31 77,31 76,31 75,31 74,31 73,31 72,31 71,31 70,31 69,31 68,31 67,31 66,31 65,30 64,29 63,28 62,28 61,28 60,27
59,8 59,9 59,10 59,11 59,12 59,13 59,14 59,15 59,16 59,17 59,18 59,19 59,20 59,21 59,22 59,23 59,24 59,25 59,26 59,27 59,28 59,29 58,30 57,31 56,32 55,33
27,50 27,49 27,48 27,47 27,46 27,45 27,44 27,43 26,42 26,41 26,40 26,39 26,38 26,37 26,36 25,35 25,34 26,33 27,32 27,31 27,30 27,29 27,28 27,27 27,26 27,25 27,24 26,23 27,22
204,71 204,70 203,69 202,68 201,67 200,66 199,65 198,64
213,85 214,86 215,87 216,88 217,89 218,90 219,91 220,92 221,93 222,94 223,95 224,96 225,97 226,98 227,99 228,100 229,101 230,102 231,103 232,104 233,105 234,106 235,107 236,108 237,109 238,110 239,111 240,112 241,113 242,114
224,117 224,118 223,119 223,120 223,121 224,122
108,120 108,119 108,118 109,117 110,117 111,117 112,117 113,117 114,117 115,117 116,117 117,117 118,117 119,117 120,117
74,61 74,62 74,63 74,64 74,65 74,66 74,67 74,68 74,69 74,70 74,71 74,72 74,73 74,74 74,75 74,76 74,77 75,78 76,79 77,80 78,81 78,82 79,83 80,84 81,85 82,86 83,87
93,132 92,132 91,132 90,132 89,133 88,134 87,135 86,136 85,137 84,138 83,139 82,140 81,141 80,142 79,143 78,144 77,145 76,146 75,147 74,148 73,149 72,150 71,150 70,151 69,152 68,153
203,75 204,74 205,73 206,72 207,71 208,70 209,69 210,68 211,67 212,66 213,65 214,64 215,63 215,62 215,61 216,60 217,59 218,58 219,57 220,56 221,56 222,55 223,54 224,53 225,52 226,51 227,50 228,49
236,41 235,41 234,41 233,41 232,41 231,41 230,41 229,42 228,43 227,44 226,45 225,45 224,45 223,44 223,43 222,42 222,41
54,94 55,95 56,96 57,97 58,98 59,99 60,100 61,101 62,102 63,103 64,104 65,105 65,106 66,107 67,108 68,109 69,109 70,109 71,109 72,109 73,109 74,109 75,109 76,109 77,109 78,109 79,109 80,110 81,111
